name = The Pink Gun



          % % % % %
                  %
%                 %
%                 %
%                 %
%                 %       +
% p               %       o        -        % %
% %                % % % % % % % %            %
%                       +     +         +     %
%    S                  X     X         E     %
% % % % % % W W % % % % W % % W % % % % % % % %
% % % % % % % % % % % % % % % % % % % % % % % %
