name = A Walk in the Park
             X       X       X
                X        X      X

                 X       X       X
             X       X       X

             X       X       X
                X        X       X
             X X     X   X   X   X
                X        X       X
%            X       X       X                                    %
%            X   X    X X    X   X                                %
%                                                                 %
%                                                                 %
%                                                                 %
%         % % % % % % % % % % % % % %                             %
%                                                                 %
%                                                            +    %
%    S                                                       E    %
% % % % % % % % % % % % % % % % % % % % % % % % % % % % % % % % % %
% % % % % % % % % % % % % % % % % % % % % % % % % % % % % % % % % %
